 11111111
110000001
100W01001
110101111
 10001
 11111