111111
111011
1E0001
110101
111111