NO ./textures/wall_n_1.xpm
NO ./textures/wall_s_1.xpm
NO ./textures/wall_n_2.xpm
NO ./textures/wall_s_2.xpm
NO ./textures/wall_n_3.xpm
NO ./textures/wall_s_3.xpm
SO ./textures/wall_s_1.xpm
SO ./textures/wall_s_2.xpm
SO ./textures/wall_s_3.xpm
WE ./textures/wall_w_1.xpm
EA ./textures/wall_e.xpm
F 020,100,0
C 020,50,150

111111
111011
1S0001
110101
111111
