NO ./textures/wall_n.xpm
SO ./textures/wall_s.xpm
WE ./textures/wall_w.xpm
EA ./textures/wall_e.xpm

        1111111111111111111111111
        1000000000110000000000001
        1011000001110000001000001
        1001000000000000000000001
111111111011000001110000000000001
100000000011000001110111111111111
11110111111111011100000010001
 1110111111111011101010010001
11000000110101011101000010001
10001000000000001101000010001
10000000000000001101010010001
11000001110101011100000000N0111
 1110111 1110101 101100000001
  111111 1111111 111111111111


F 020,100,0
C 020,50,150